#############.....#############
...............................
...............................
...............................
#........#...........#........#
#........#...........#........#
#........#...........#........#
#........#...........#........#
#........#...........#........#
#........#...........#........#
...............................
...............................
...............................
#........#...........#........#
#........#...........#........#
#........#...........#........#
#........#...........#........#
#........#...........#........#
#........#...........#........#
...............................
...............................
...............................
#############.....#############
