#############.....#############
#...........#.................#
#...........#.................#
#...........#.................#
#...#...#...###############...#
#...#...#.....................#
#...#...#.....................#
#...#...#.....................#
#...#...#...###########...#####
....#...#.............#...#....
....#...#.............#...#....
....#...#.............#...#....
....#...#.............#...#....
....#...#.............#...#....
#####...###########...#...#...#
#.....................#...#...#
#.....................#...#...#
#.....................#...#...#
#...###############...#...#...#
#.................#...........#
#.................#...........#
#.................#...........#
#############.....#############
