#########...#######...#########
...............................
...............................
...............................
####...#######...#######...####
...............................
...............................
...............................
..#######...#######...#######..
...............................
...............................
...............................
...............................
...............................
..#######...#######...#######..
...............................
...............................
...............................
####...#######...#######...####
...............................
...............................
...............................
#########...#######...#########
