############.......############
#.............................#
#.............................#
#.............................#
#.............................#
#.............................#
#.............................#
#.......###############.......#
...............................
...............................
...............................
...............................
...............................
...............................
...............................
#.......###############.......#
#.............................#
#.............................#
#.............................#
#.............................#
#.............................#
#.............................#
############.......############
