#...#######################...#
#.............................#
#.............................#
#.............................#
#.............................#
######....###########....######
#.........#.........#.........#
#.........#.........#.........#
#.........#.........#.........#
#....######.........######....#
...............................
...............................
...............................
#....######.........######....#
#.........#.........#.........#
#.........#.........#.........#
#.........#.........#.........#
######....###########....######
#.............................#
#.............................#
#.............................#
#.............................#
#...#######################...#
